//MAP CONVERTED BY dmm2tgm.py THIS HEADER COMMENT PREVENTS RECONVERSION, DO NOT REMOVE
"a" = (
/turf/closed/wall/mineral/plastitanium,
/area/space)
"c" = (
/obj/structure/chair/office/dark{
	dir = 8
	},
/turf/open/floor/plasteel/dark,
/area/space)
"g" = (
/turf/open/floor/wood,
/area/space)
"h" = (
/obj/machinery/light{
	dir = 1
	},
/turf/open/floor/wood,
/area/space)
"j" = (
/turf/open/floor/mineral/basaltstone_floor,
/area/space)
"l" = (
/obj/machinery/light/small{
	dir = 1
	},
/obj/structure/chair/sofachair{
	dir = 8
	},
/turf/open/floor/mineral/basaltstone_floor,
/area/space)
"n" = (
/obj/effect/turf_decal/tile/red{
	dir = 1
	},
/obj/effect/turf_decal/tile/red{
	dir = 8
	},
/obj/effect/turf_decal/loading_area{
	dir = 8;
	icon_state = "drain";
	name = "drain"
	},
/obj/machinery/door/window/brigdoor/westleft,
/turf/open/floor/plasteel/dark,
/area/space)
"o" = (
/obj/structure/chair/sofachair{
	dir = 8
	},
/turf/open/floor/mineral/basaltstone_floor,
/area/space)
"p" = (
/obj/effect/turf_decal/tile/red{
	dir = 1
	},
/obj/effect/turf_decal/tile/red{
	dir = 8
	},
/obj/effect/turf_decal/loading_area{
	dir = 8;
	icon_state = "drain";
	name = "drain"
	},
/obj/structure/window/reinforced/spawner/west,
/turf/open/floor/plasteel/dark,
/area/space)
"u" = (
/obj/effect/turf_decal/tile/red{
	dir = 1
	},
/obj/effect/turf_decal/tile/red{
	dir = 8
	},
/obj/effect/turf_decal/loading_area{
	dir = 8;
	icon_state = "drain";
	name = "drain"
	},
/obj/structure/window/reinforced/spawner/west,
/obj/structure/closet/secure_closet{
	req_one_access_txt = "150"
	},
/turf/open/floor/plasteel/dark,
/area/space)
"y" = (
/obj/structure/chair/sofa/left{
	dir = 1
	},
/turf/open/floor/wood,
/area/space)
"z" = (
/obj/machinery/computer/camera_advanced/shuttle_docker/syndicate{
	name = "shuttle navigation computer";
	desc = "Used to designate a precise transit location for the shuttle."
	},
/turf/open/floor/plasteel/dark,
/area/space)
"G" = (
/obj/structure/chair/sofa/right{
	dir = 1
	},
/turf/open/floor/wood,
/area/space)
"H" = (
/obj/machinery/light,
/obj/structure/chair/sofa{
	dir = 1
	},
/turf/open/floor/wood,
/area/space)
"J" = (
/obj/machinery/computer/shuttle/syndicate{
	name = "shuttle terminal"
	},
/turf/open/floor/plasteel/dark,
/area/space)
"K" = (
/obj/machinery/door/airlock/abductor,
/obj/structure/fans/tiny,
/turf/open/floor/plating,
/area/space)
"M" = (
/obj/structure/shuttle/engine/propulsion{
	dir = 8
	},
/turf/open/floor/plating/airless,
/area/space)
"P" = (
/obj/item/kirbyplants/photosynthetic,
/turf/open/floor/wood,
/area/space)
"Q" = (
/turf/open/space/basic,
/area/space)
"S" = (
/obj/structure/falsewall/plastitanium,
/obj/machinery/door/window/brigdoor/northright{
	layer = 1
	},
/turf/open/floor/mineral/basaltstone_floor,
/area/space)
"Y" = (
/obj/structure/shuttle/engine/heater{
	dir = 8
	},
/obj/structure/window/reinforced{
	dir = 4
	},
/turf/open/floor/plating/airless,
/area/space)
"Z" = (
/obj/effect/spawner/structure/window/plastitanium,
/turf/open/floor/plating,
/area/space)

(1,1,1) = {"
Q
M
M
M
Q
Q
Q
Q
"}
(2,1,1) = {"
a
Y
Y
Y
a
a
a
a
"}
(3,1,1) = {"
K
g
g
G
S
j
j
a
"}
(4,1,1) = {"
a
h
g
H
a
l
o
a
"}
(5,1,1) = {"
Z
P
g
y
a
a
a
a
"}
(6,1,1) = {"
Z
u
n
p
a
Q
Q
Q
"}
(7,1,1) = {"
a
J
c
z
a
Q
Q
Q
"}
(8,1,1) = {"
a
Z
Z
Z
a
Q
Q
Q
"}
